***X*X**X***X
************X
************X
************X
X*XX**XXXXXX*
X***X**XX****
X*X******X*XX
X*XX**XXXX*X*
X***X**XX****
X*XX**XXXXXX*
X***X**XX****
X*X******X*XX
****X*XX*****